sequence	bimera
GTGACCAGTTCACACGCCAACATGACCAAGCGCTCTTTTAATTTTCCGCTTCCCCAAGCAGACAGATGAACGACTAATCGAACGAACGTATGAATACATGCGCATGTTTCCACTGCACATA	FALSE
CATCATTTAGTAAAGACAGGTAATAAAAAATGTAATTGTGGCACATGGAGCCTTTTACCTTCATGAGGTGCATACACGTGTTAAATAACTTTTTCGCAAATTTTTCATCTGTAATTTGCATTAAGTTGTAACTTCGCAGGGGGGGGTTATCACTGTGAAGTTTGATTTGCTGCAGTG	FALSE
CCTGAGGACGCCACCTGCGTTGTTGAGAGAAATTCGAAGAAGGCAGAGTGCAGGTGCGAGGAAGGGAAGTACCTTCACAAAAATGAGTGCTACAACATGGAAGAATTGGAGAGACTCATAAA	FALSE
AAGGGACCGAGATATTTTGCGAATATATTTCACAAACTGCTTATTCTCCTTCTTATTATTGTACACGTATATGACGATGTGGAGCACTCGGTTCTTTCTCGGAGGAAACTTAGAAAGAGTTAACTCGTTTATAATGCGGGTGTACATTTTATTTATAAAATGAATATCCTCTTGATCATTGAAACGAAAGTAAAT	FALSE
CCTGAGGACGCCACCTGCGTTGTTGAGAGAAATTCGAAGAAGGCAGAGTGCAGGTGCGAGGAAGGGAAGTACCTTCACAAAAATGAGTGCTACAACATGGCAGAATTGGAGAGACTCATAAA	FALSE
GTAAGTGCAAAAAAAAGGCACATATGTATGTGTGCACTGCTGTGCGTGCCATCGCATACCTGCGCTGAGTGCTTGGATAGGTACGTCTGTT	FALSE
GTAAGTGCAAAAAAAAGGCACATATGTATGTGTGCACTGCTGTGCGTGCCATCGCATACCTGCGCTGAGTGCTTGGACAGGTACGTCTGTT	FALSE
AGAATGCGTGCAAAAAGTCAGACGTGGATCCAAACCTTATTGAAGATCTAATGAATGAACGAGTTTTAATCAACACGAGAAATATGCCCTCTAAAAATTTAAGTAATAAAAAAACGTTTATATCAATGGAAGGAAAATTAAAATATACTGACTTAAACTATTCCAGCATTGATGCATATAA	FALSE
AAACTTAGGCGCATCAAATAGTCGACCTTCTGAGTCCACCGTTAAAGCAAATAGCCCAGGTGATGATACTGTGAACAGTGCATCTATACCTGTAGTGAGTGGTGAAAAC	FALSE
AAACTTAGGCGCATCAAATAGTCGACCTTCTGAGTCCACCGTTGAAGCAAATAGCCCAGGTGATGATACTGTGAACAGTGCATCTATACCTGTAGTGAGTGGTGAAAAC	FALSE
GCTAACCACTGCAGTTAGTGAATACGAAGCGATAGCTAATTCTATTAGAAAAGAATTTACAAATATAAG	FALSE
GCTAACCGCTGCAGTTAGTGAATACGAAGCGATAGCTAATTCTATTAGAAAAAAATTTACAAATATAAG	FALSE
GTACATGGGCATTGAAAAAAGGGGGGCAAGGAAAACCGCATAGGACGACTGTGGGGG	FALSE
GTGACCAGTTCACACGCCAACATGACCAAGCGCTCTTTTAATTTTCCGCTTCCCCAAGCAGACAGATGAACGACTAATCGAACGAACGTATAAATACATGCGCATGTTTCCACTGCACATA	FALSE
AAGGGACCGAGATATTTTGCGAATATATTTCACAAACTGCTTATTCTCCTTCTTATTATTGTACACGTATATGACGATGTGGAGCACTCGGTTCTTTCTCGGAGGAAACTTAGAAAGAGTTAACTCGTTTATAATGCGGGTGTACATTTTATTTATAAAATGAATATCCTCTTGATCATTGAAACGAAAGTAAAG	TRUE
GTGACCAGTTCACACGCCAACATGACCAAGCGCTCTTTTAATTTTCCGCTTCCCCAAGCAGACAGATGAACGACTAATCGAACGAACGTATGAATACATGCGCATGTTTCCACTACACATA	FALSE
CCTGAGGACGCCACCTGCGTTGTTGAGAGAAATTCGAAGAAGGCAGAGTGCAGGTGCGAGGAAGGGAAGTACCTTCACAAAAATGAGTGCTACAACATGACAGAATTGGAGAGACTCATAAA	FALSE
AAGGGACCGAGATATTTTGCGAATATATTTCACAAACTGCTTATTCTCCTTCTTATTATTGTACACGTATATGACGATGTGGAGCACTCGGTTCTTTCTCGGAGGAAACTTAGAAAGAGTTAACTCGTTTATAATGCGGGTGTACATTTTATTTATAAAATGAATATCCTCTTTATCATTGAAACGAAAGTAAAT	FALSE
TTGACCAGTTCACACGCCAACATGACCAAGCGCTCTTTTAATTTTCCGCTTCCCCAAGCAGACAGATGAACGACTAATCGAACGAACGTATGAATACATGCGCATGTTTCCACTGCACATA	TRUE
CGAATGCGTGCAAAAAGTCAGACGTGGATCCAAACCTTATTGAAGATCTAATGAATGAACGAGTTTTAATCAACACGAGAAATATGCCCTCTAAAAATTTAAGTAATAAAAAAACGTTTATATCAATGGAAGGAAAATTAAAATATACTGACTTAAACTATTCCAGCATTGATGCATATAA	TRUE
GGGAGGTGTGAATGGGTTGCCCCCGAGTGGAGCGCGCATAGGAGGCTTCGTTTATGCTTGTATAAGTCCTAGATAC	FALSE
CATCATTTAGTAAAGACAGGTAATAAAAAATGTAATTGTGGCACATGGAGCCTTTTACCTTCATGAGGTGCATACACGTGTTAAATAACTTTTTCGCAAATTTTTCATCTGTAATTTGCATTAAGTTGTAACTTCGCAGGGGGGGGGTTATCACTGTGAAGTTTGATTTGCTGCAGTG	FALSE
TCGTGGCGGTCCAAGCGATAGCCACACGTGGAGGTGTTGCCCCCACAGGTAGAGCACCAAACGGTAGAGCAACCGCGTGAATAAGCACTCCCC	FALSE
GAGCATGTGTGCGTGTGTATAAGTGTGCATGTATGTTAACATGTGAGAGGGTGTGTATAGGTGCATATGCGCATTAATGAACACGTGAGAGTATGCAGGTGTATGTGTGTGAGTGCATGCGTGTGTATGAGCGTGCATGTATGCATTACAGTGTGTGTTAGCAAGCATATGTATTTGTGCACGT	FALSE
CGCAGCATCTATGTAATCGCTTTAAAACATTCCCACTTGAATAACGACTTTCGCATTTGGGTGGTTGGGGTGTCCTTCCT	FALSE
